%%%%%%%%%%%%
%%%%%%%%%%%%
%%%%   %%%%%
%%%% ..%%%%%
%%%% ..%%%%%
%%%% ..%%%%%
%%%%   %%%%%
%%%%%%%%%%%%
%%%%%%%%%%%%
#
%%%%%%%%%%%%
%%%%%%%%%%%%
%%%%%%%%%%%%
%%%P  ...%%%
%%%   ...%%%
%%%   ...%%%
%%%    ..%%%
%%%%%%%%%%%%
%%%%%%%%%%%%
#
%%%%%%%%%%%%
%%%%%%%%%%%%
%%%%%%%%%%%%
%%%%%%%%%%%%
%%     ..%%%
%%%%%%%%%%%%
%%%%%%%%%%%%
%%%%%%%%%%%%
%%%%%%%%%%%%
#
