%%%%%%%%%%%%%%%%%%%%%
%P  %   % %         %
% %%%%%%% % %%% %%% %
%     %   % % % %   %
% %%%%%%% % %%%%%%%%%
% % %     %   %    %%
% % % %%% %%  %%%% %%
%%% % %% %%%%   %% %%
%   % %  %%    %%%% %
%%  %%%%  %%%% %%  %%
%%% %. %%%%% %%%%% %%
%%%%%%%%%%%%%%%%%%%%%
#
%%%%%%%%%%%%%%%%%%%%%
%  %% % % %   %%%   %
% %%%%%%% % %%% %%% %
%   %%%% %  % %%%   %
%      %% % %%%%%%%%%
% % %     %   %  % %%
% % % %%  %%  %%%% %%
%%% % %% %%%% %%%% %%
%   % %  %% %  %%%% %
%%  %%%%  %%   %%  %%
%   %     %%   %%% %%
%%%%%%%%%%%%%%%%%%%%%
#
%%%%%%%%%%%%%%%%%%%%%
%%% %   % %  %.%%   %
%%%%% %%% % %%% %%% %
%%  %%%   % % % %   %
% %%  %%%%   %%%%%%%%
% % % %   %   %    %%
% % % %%% %%  %%%% %%
%%% % %% %%%  % %% %%
%   % %  %%   %.%%% %
%%  %%%%  %%%% %%  %%
%%%    %%%%% %%%%% %%
%%%%%%%%%%%%%%%%%%%%%
#