%%%%%%
%P %.%
%%%%%%
#
%%%%%%
% % %%
%%%%%%
#
%%%%%%
% %. %
%%%%%%
#