%%%%%%%%%%%%%%
%%%%%%%%%%%%%%
%%%%%    %%%%%
%%%%%    %%%%%
%%%%% ...%%%%%
%%%%% ...%%%%%
%%%%% ...%%%%%
%%%%%    %%%%%
%%%%%    %%%%%
%%%%%%%%%%%%%%
%%%%%%%%%%%%%%
#
%%%%%%%%%%%%%%
%%%%%%%%%%%%%%
%%%%%%%%%%%%%%
%%%P     ..%%%
%%%     ...%%%
%%%     ...%%%
%%%     ...%%%
%%%      ..%%%
%%%%%%%%%%%%%%
%%%%%%%%%%%%%%
%%%%%%%%%%%%%%
#
%%%%%%%%%%%%%%
%%%%%%%%%%%%%%
%%%%%%%%%%%%%%
%%%%%%%%%%%%%%
%%%%%%%%%%%%%%
%%       ...%%
%%       ...%%
%%%%%%%%%%%%%%
%%%%%%%%%%%%%%
%%%%%%%%%%%%%%
%%%%%%%%%%%%%%
#
