%%%%%%%
%P    %
%%%%% %
%  %  %
%% % %%
%. %%%%
%%%%%%%
#
%%%%%%%
%%%% %%
% %%  %
% %%  %
% %  %%
% %%%%%
%%%%%%%
#
%%%%%%%
%.    %
% %%  %
%  %  %
%%   %%
%  %%%%
%%%%%%%
#